{
  "ground": [
    {"x" :  0, "y":  18},
    {"x" :  1, "y":  18},
    {"x" :  2, "y":  18},
    {"x" :  3, "y":  18},
    {"x" :  4, "y":  18},
    {"x" :  5, "y":  18},
    {"x" :  6, "y":  18},
    {"x" :  7, "y":  18},
    {"x" :  8, "y":  18},
    {"x" :  9, "y":  18},
    {"x" :  10, "y":  18},
    {"x" :  11, "y":  18},
    {"x" :  12, "y":  18},
    {"x" :  13, "y":  18},
    {"x" :  14, "y":  18},
    {"x" :  15, "y":  18},
    {"x" :  16, "y":  18},
    {"x" :  17, "y":  18},
    {"x" :  18, "y":  18},
    {"x" :  19, "y":  18},
    {"x" :  20, "y":  18},
    {"x" :  21, "y":  18},
    {"x" :  22, "y":  18},
    {"x" :  23, "y":  18},
    {"x" :  24, "y":  18},
    {"x" :  25, "y":  18},
    {"x" :  26, "y":  18},
    {"x" :  27, "y":  18},
    {"x" :  28, "y":  18},
    {"x" :  29, "y":  18},
    {"x" :  30, "y":  18},
    {"x" :  31, "y":  18},
    {"x" :  32, "y":  18},
    {"x" :  33, "y":  18},
    {"x" :  34, "y":  18},
    {"x" :  35, "y":  18},
    {"x" :  36, "y":  18},
    {"x" :  37, "y":  18},
    {"x" :  38, "y":  18},
    {"x" :  39, "y":  18},
    {"x" :  40, "y":  18},
    {"x" :  41, "y":  18},
    {"x" :  42, "y":  18},
    {"x" :  43, "y":  18},
    {"x" :  44, "y":  18}
  ],
  "goal" : [
    {"x": 44, "y":  17}
  ]
}
